WWWWWWWW
W      W
W      W
W  s   W
W      W
W  W   W
W      W
W      W
WWWWWWWW